NO ./pictures/wood.XPM
SO ./pictures/wood.XPM
WE ./pictures/wood.XPM
EA ./pictures/wood.XPM

F 20,42,64
C 50,109,168

        1111111111111111111111111
        1000000000110000000000001
        1011000001110000000000001
111111111000000000000000011111111
111111111011000001110000000000001
100000000011000001110111111111111
111111111111110111000000100011
        1111011111111101110101
        1100011001101010111001
        100000000N000111000111
        100000000000011101011
11111111110101011111011100011
11110111 1110101 101111010001
11111111 1111111 111111111111
