NO ./pictures/wood.xpm
SO ./pictures/greystone.xpm
WE ./pictures/colorstone.xpm
EA ./pictures/wood.xpm

F 32,32,32
C 150,255,255

111111111111111111111111111111111
        1000000000110000000000001
        1011000001110000000000001
1111111110000E0000000000011111111
111111111011000001110000000000001
100000000011000001110111111111111
111111111111110111000000100011
        1111011111111101110101
        1101111101101010111001
        100111 100000111000111
        100111110000011101011
11111111110101011111011100011
11110111 1110101 101111010001
11111111 1111111 111111111111
